Postreq,prereq_failed_postreq_taken,prereq_failed_postreq_not_taken,prereq_failed_postreq_passed,prereq_failed_postreq_passed_probability,prereq_failed_postreq_failed,prereq_failed_postreq_taken_probability,prereq_passed_postreq_taken,prereq_passed_postreq_not_taken,prereq_passed_postreq_passed,prereq_passed_postreq_passed_probability,prereq_passed_postreq_failed,prereq_passed_postreq_taken_probability
Applications in Information Systems,1,0,1,1.0,0,1.0,71,11,71,0.8658536585365854,0,0.8658536585365854
Artificial Intelligence,15,119,14,0.1044776119402985,1,0.11194029850746269,69,228,68,0.22895622895622897,1,0.23232323232323232
Business Analytics,1,36,0,0.0,1,0.02702702702702703,13,133,13,0.08904109589041095,0,0.08904109589041095
Calculus and Analytic Geometry I,48,67,23,0.2,25,0.41739130434782606,137,18,110,0.7096774193548387,27,0.8838709677419355
Calculus and Analytic Geometry II,27,120,13,0.08843537414965986,14,0.1836734693877551,137,48,114,0.6162162162162163,23,0.7405405405405405
Calculus and Analytic Geometry III,29,53,26,0.3170731707317073,3,0.35365853658536583,136,13,127,0.8523489932885906,9,0.912751677852349
Circuit Modeling I,21,126,16,0.10884353741496598,5,0.14285714285714285,86,99,70,0.3783783783783784,16,0.4648648648648649
College Algebra,4,24,2,0.07142857142857142,2,0.14285714285714285,23,23,19,0.41304347826086957,4,0.5
College Writing II,8,53,7,0.11475409836065574,1,0.13114754098360656,374,29,338,0.8387096774193549,36,0.9280397022332506
Computer Architecture/Operating Systems,10,81,8,0.08791208791208792,2,0.10989010989010989,299,72,280,0.7547169811320755,19,0.8059299191374663
Computer Graphics,12,107,11,0.09243697478991597,1,0.10084033613445378,48,259,48,0.1563517915309446,0,0.1563517915309446
Corporate Finance,2,22,1,0.041666666666666664,1,0.08333333333333333,73,125,70,0.35353535353535354,3,0.3686868686868687
Data Communications and Computer Networks,18,73,15,0.16483516483516483,3,0.1978021978021978,329,42,307,0.8274932614555256,22,0.8867924528301887
Database Design and Implementation,53,97,48,0.32,5,0.35333333333333333,317,87,301,0.745049504950495,16,0.7846534653465347
Discrete Mathematics,59,88,35,0.23809523809523808,24,0.4013605442176871,154,31,130,0.7027027027027027,24,0.8324324324324325
Discrete Structures,0,0,0,0.0,0,0.0,0,0,0,0.0,0,0.0
Elementary Algebra,0,0,0,0.0,0,0.0,0,0,0,0.0,0,0.0
Elementary Statistics,9,24,6,0.18181818181818182,3,0.2727272727272727,16,33,15,0.30612244897959184,1,0.32653061224489793
Financial Accounting,6,0,5,0.8333333333333334,1,1.0,113,8,107,0.8842975206611571,6,0.9338842975206612
Finite Mathematics with Applications,5,23,3,0.10714285714285714,2,0.17857142857142858,8,38,8,0.17391304347826086,0,0.17391304347826086
Fundamentals of Engineering Analysis Tools,0,0,0,0.0,0,0.0,0,0,0,0.0,0,0.0
General Physics I,21,126,20,0.1360544217687075,1,0.14285714285714285,105,80,103,0.5567567567567567,2,0.5675675675675675
General Physics II,26,63,24,0.2696629213483146,2,0.29213483146067415,158,61,148,0.6757990867579908,10,0.7214611872146118
Human Factors Engineering,1,81,1,0.012195121951219513,0,0.012195121951219513,6,143,6,0.040268456375838924,0,0.040268456375838924
Intermediate Algebra,1,5,1,0.16666666666666666,0,0.16666666666666666,10,0,7,0.7,3,1.0
Intermediate Software Engineering,13,63,13,0.17105263157894737,0,0.17105263157894737,203,133,202,0.6011904761904762,1,0.6041666666666666
Interpretation of Business and Economic Data,2,10,2,0.16666666666666666,0,0.16666666666666666,9,54,9,0.14285714285714285,0,0.14285714285714285
Introduction to Computer Security,7,84,7,0.07692307692307693,0,0.07692307692307693,149,222,146,0.3935309973045822,3,0.40161725067385445
Introduction to Microprocessors,1,146,1,0.006802721088435374,0,0.006802721088435374,107,326,106,0.24480369515011546,1,0.2471131639722864
Introduction to Software Engineering,23,68,11,0.12087912087912088,12,0.25274725274725274,309,62,302,0.8140161725067385,7,0.8328840970350404
Logic and Digital Design,21,65,20,0.23255813953488372,1,0.2441860465116279,145,191,142,0.4226190476190476,3,0.43154761904761907
Object Oriented Analysis and Design,16,94,16,0.14545454545454545,0,0.14545454545454545,288,106,282,0.7157360406091371,6,0.7309644670050761
Object-Oriented Programming and Data Structures I,39,101,25,0.17857142857142858,14,0.2785714285714286,360,44,318,0.7871287128712872,42,0.8910891089108911
Object-Oriented Programming and Data Structures II,13,78,8,0.08791208791208792,5,0.14285714285714285,302,69,270,0.7277628032345014,32,0.8140161725067385
Operations Management,2,50,1,0.019230769230769232,1,0.038461538461538464,28,472,26,0.052,2,0.056
Operations Research I,0,10,0,0.0,0,0.0,10,158,9,0.05357142857142857,1,0.05952380952380952
Organizational Behavior,1,38,1,0.02564102564102564,0,0.02564102564102564,70,422,69,0.1402439024390244,1,0.14227642276422764
Precalculus,2,46,1,0.020833333333333332,1,0.041666666666666664,18,8,13,0.5,5,0.6923076923076923
Principles and Applications of Project Management,0,0,0,0.0,0,0.0,7,2,7,0.7777777777777778,0,0.7777777777777778
Programming in C++,2,15,1,0.058823529411764705,1,0.11764705882352941,153,16,125,0.7396449704142012,28,0.9053254437869822
Programming Language Structures,23,31,18,0.3333333333333333,5,0.42592592592592593,241,36,234,0.8447653429602888,7,0.8700361010830325
Quality Engineering,0,10,0,0.0,0,0.0,9,159,9,0.05357142857142857,0,0.05357142857142857
Quality Management,0,39,0,0.0,0,0.0,30,462,30,0.06097560975609756,0,0.06097560975609756
Real-Time Embedded Systems Programming,14,84,13,0.1326530612244898,1,0.14285714285714285,147,184,145,0.4380664652567976,2,0.44410876132930516
Software Engineering Project II,0,5,0,0.0,0,0.0,138,49,137,0.732620320855615,1,0.7379679144385026
Software Engineering Project I,19,106,18,0.144,1,0.152,141,154,139,0.4711864406779661,2,0.47796610169491527
Software Maintenance and Reengineering,15,81,15,0.15625,0,0.15625,175,164,174,0.5132743362831859,1,0.5162241887905604
Software Quality,10,44,10,0.18518518518518517,0,0.18518518518518517,180,97,179,0.6462093862815884,1,0.6498194945848376
Statistical Methods with Applications,24,58,21,0.25609756097560976,3,0.2926829268292683,115,34,108,0.7248322147651006,7,0.7718120805369127
Systems Analysis and Design,5,22,5,0.18518518518518517,0,0.18518518518518517,89,60,89,0.5973154362416108,0,0.5973154362416108
Systems Development and Implementation,5,22,5,0.18518518518518517,0,0.18518518518518517,76,73,76,0.5100671140939598,0,0.5100671140939598
Technical Writing,15,98,13,0.11504424778761062,2,0.13274336283185842,216,293,208,0.4086444007858546,8,0.4243614931237721
Trigonometry and Analytic Geometry,21,41,15,0.24193548387096775,6,0.3387096774193548,56,17,48,0.6575342465753424,8,0.7671232876712328
"Web Protocols, Technologies, and Applications",0,0,0,0.0,0,0.0,0,0,0,0.0,0,0.0
Windows Programming,13,84,12,0.12371134020618557,1,0.13402061855670103,172,226,163,0.40954773869346733,9,0.4321608040201005
